1111111111111111111111111111111
1111111111111111111111111111111
110000000000000000C000000000111
1111110101011101010111010111011
1100000100000C00000001000001011
1101010101010111010101010101011
110101C010000000000000000001001
1101010101010101110101011101011
110001000C010000000000000000011
1101010101110101011101010101011
110000C000010010000C10000C00011
1101010101010101010101010101011
110100000001000C100000100000011
1101010101110111010101011101011
11000001000000P0C001000C0010011
1101010101010101011101010101011
1100000000000C00E00000000000111
1101011101010101111101010111011
1100000000000001000010000000011
1101010111010101010111010101011
11000100000C0000000000100001001
1101010101010101010101010101011
1100000000000010000000000000011
1101010101010101110101010101011
1100000010000000000000C00000011
1101011101010101011101010111011
110100000001000000C001000001011
1101010111010101110101010111011
1100000000C00000000000000000111
1111111111111111111111111111111