111111111111111111111111111111111111111111111111111111111111
1000000000000000000000P0000000E000C1111111111111111111110011
111111111111111111111111111111111111111111111111111111111111