1111111111111111111111111111
1CCECCCCCCCCCCCCCCCPCCCCCCC1
1111111111111111111111111111